{
  "grid": {
    "columns": 31,
    "rows": 13,
    "cellSize": 32
  },
  "origin": {
    "x": 16,
    "y": 80
  },
  "tiles": [
    "###############################",
    "#1......BBB....B.......B.....P#",
    "#.#B#.#.#.#.#B#.#.#B#.#.#.#B#.#",
    "#..BB.B.B....B..BB.oB...B....B#",
    "#.#d#.#.#.#.#.#.#B#.#.#.#.#.#.#",
    "#....B.......B..B.......BB..BB#",
    "#.#.#B#.#.#.#.#B#.#.#.#.#.#B#.#",
    "#...B..B.....BBB..a.....B.....#",
    "#.#.#.#.#a#B#.#B#.#B#.#.#.#.#.#",
    "#BB........B.BBBB..B..........#",
    "#.#.#.#.#.#.#.#.#.#B#o#B#.#.#.#",
    "#..Bd....BBB......B.B...B..X..#",
    "###############################"
  ]
}
