{
  "grid": {
    "columns": 31,
    "rows": 13,
    "cellSize": 32
  },
  "origin": {
    "x": 16,
    "y": 80
  },
  "tiles": [
    "###############################",
    "#12B..BB.o....BB.......B......#",
    "#.#B#.#.#B#.#B#.#.#a#.#.#.#.#B#",
    "#.BBB........B.BB.BP...a....B.#",
    "#.#.#.#B#.#.#B#.#.#.#.#.#.#B#.#",
    "#....B.....B.....B.......B....#",
    "#B#B#.#o#B#.#B#.#.#.#.#.#.#B#.#",
    "#...B.B..B...B....B...B.B.....#",
    "#.#o#.#.#.#.#B#B#.#.#.#.#.#.#.#",
    "#B..B.B..............B...BB.BX#",
    "#.#.#B#.#.#.#B#.#.#B#B#.#.#.#.#",
    "#.......BB......Ba.B..........#",
    "###############################"
  ]
}
