{
  "grid": {
    "columns": 31,
    "rows": 13,
    "cellSize": 32
  },
  "origin": {
    "x": 16,
    "y": 80
  },
  "tiles": [
    "###############################",
    "#1.........B.....B............#",
    "#.#.#B#.#.#.#.#.#.#B#.#.#.#.#.#",
    "#B.BB.B....BB..B.B..B.B...BPB.#",
    "#.#.#B#.#.#.#.#.#.#.#.#.#.#.#B#",
    "#...BB..BBBB...B...B.BB.B..B..#",
    "#.#a#.#.#.#.#a#.#.#.#B#B#.#.#.#",
    "#..B............a.B.BB.B......#",
    "#B#.#.#.#.#B#.#.#.#.#.#.#.#.#.#",
    "#.B.B.BB.B.B.B............X...#",
    "#.#.#.#.#.#.#.#B#.#.#.#.#.#.#.#",
    "#B.BB.aa..B.......B......a....#",
    "###############################"
  ]
}
