{
  "grid": {
    "columns": 31,
    "rows": 13,
    "cellSize": 32
  },
  "origin": {
    "x": 16,
    "y": 80
  },
  "tiles": [
    "###############################",
    "#1......BB......B......BBBB..B#",
    "#.#.#.#m#.#B#.#.#.#.#.#.#B#.#B#",
    "#...P...B.....BBB....B........#",
    "#.#.#.#.#.#.#.#.#.#B#B#.#B#B#.#",
    "#.B....B............a..BBB....#",
    "#B#.#.#B#.#B#.#.#.#.#.#.#.#B#.#",
    "#BBB..oBB..Bd....B....B......B#",
    "#.#.#B#.#.#B#.#.#.#.#B#B#B#.#B#",
    "#B........dB...B....B.B...B...#",
    "#B#.#B#.#.#.#.#.#.#.#.#B#.#X#.#",
    "#B...B...m.....B..B....B......#",
    "###############################"
  ]
}
